1111111111111111111111
1010001111101110101111
10101011100C1111111011
1X00000P00E00000X01111
1111111111111111111111