11111111111111
100100C0000C11
1C00011111P011
1P0011E0000011
11111111111111